THERE	COMES	MEGAHERTZ
ABOUT	HOUSE	PAJAMA
WOULD	SIMILAR	BUZZING
WROTE	TODAY	FLOPPING
WHICH	WRITTEN	ESPIONAGE
OTHER	COMPLETE	ABYSS
ARTICLE	PRODUCT	WHISKEY
THEIR	PROVIDE	BOGGLE
PEOPLE	READING	ZIGZAG
THINK	SEQUENCE	GIAOUR
SHOULD	SIMPLY	ZIPPER
THESE	ASKED	YOKED
PLEASE	MAJOR	INJURY
WRITES	MONTHS	DIRNDL
COULD	SCIENCE	DISAVOW
BECAUSE	WORDS	GNOSTIC
INFORMATION	GUESS	MATRIX
WHERE	MARKET	WYVERN
SYSTEM	OFFER	SUBWAY
THOSE	PROCESS	FIXABLE
AFTER	STARTED	BUZZWORDS
ANYONE	LANGUAGE	TRANSPLANT
REALLY	NIGHT	ABRUPTLY
RIGHT	TECHNICAL	BUFFOON
BEING	UNLESS	BUZZARD
GUIDE	ANYWAY	DAIQUIRI
YEARS	COMMON	FLYBY
BEFORE	CHILDREN	VORTEX
USING	DISCUSSION	BLITZ
SOMETHING	POINTS	ONYX
AVAILABLE	SAYING	MARQUIS
SOFTWARE	SECTION	WALKWAY
SINCE	SINGLE	JOYFUL
PROBLEM	COUPLE	QUIZZES
GOING	ESPECIALLY	JIGSAW
THROUGH	ALONG	TRANSCRIPT
NEVER	BECOME	GAZEBO
WORLD	MYSELF	DUPLEX
LITTLE	WANTED	BOOKWORM
ANOTHER	FUTURE	STAFF
BETTER	GREEN	PIZAZZ
GROUP	REPORT	YACHTSMAN
WHILE	SERIES	ZIGZAGGING
NUMBER	SPEED	HAIKU
MIGHT	BELOW	LYMPH
AROUND	INTEREST	GALAXY
THINGS	TOGETHER	CYCLE
GREAT	NEEDS	JACKPOT
POINT	PROJECT	MYSTIFY
SOMEONE	REQUIRED	POLKA
WITHOUT	CURRENTLY	BOXFUL
COMPUTER	FAMILY	KIWIFRUIT
THANKS	OFFICE	KITSCH
AGAIN	VARIOUS	BUCKAROO
UNDER	APPLICATION	PNEUMONIA
MESSAGE	CENTER	PUPPY
SUPPORT	HISTORY	CALIPH
THING	MINIMUM	NOWADAYS
PROGRAM	APPLICATIONS	QUIZ
UNIVERSITY	CLOSE	GALVANIZE
CARDS	COMMAND	UNWORTHY
EXPERIENCE	KNOWN	PIXEL
FOLLOWING	SIMPLE	JIUJITSU
SYSTEMS	EXCEPT	QUORUM
BETWEEN	INTERESTING	JOGGING
EVERY	KNOWLEDGE	WAXY
HOWEVER	LINES	COBWEB
WINDOWS	RETURN	THRIFTLESS
LOOKING	YOURSELF	WHEEZY
DIFFERENT	FURTHER	ZEPHYR
VERSION	ISSUES	EXODUS
ADDRESS	SITES	JUKEBOX
ANYTHING	VALUE	LUXURY
BELIEVE	SOMETIMES	RHYTHM
MONEY	UNITED	BIKINI
PROBABLY	CERTAIN	CROQUET
ALWAYS	ERROR	QUARTZ
FOUND	VOICE	VOODOO
LEAST	WORTH	GNARLY
STATE	FRIEND	JAWBREAKER
THOUGH	REPLY	WALTZ
ACTUALLY	RESUME	KHAKI
COURSE	WHATEVER	NAPHTHA
PLACE	CAUSE	RHUBARB
EITHER	FIELD	NUMBSKULL
ORDER	RULES	PEEKABOO
PROBLEMS	TITLE	STRONGHOLD
ENOUGH	ADVANCE	LARYNX
FILES	BOARD	WELLSPRING
CALLED	DIRECTORY	VIXEN
POWER	EXCELLENT	FLUFFINESS
SOURCE	FORMAT	JAUNDICE
QUESTION	CONSIDER	PSHAW
HUMAN	MEMBERS	TOPAZ
ABOVE	SEARCH	SYNDROME
INTERESTED	SHIPPING	AFFIX
THOUGHT	SOCIETY	DIZZYING
ACCESS	TALKING	GROGGINESS
AGAINST	ACTION	IATROGENIC
GOVERNMENT	CLEAR	OVARY
START	COLLEGE	ICEBOX
CHECK	CORRECT	ABSURD
DRIVE	DEATH	EMBEZZLE
SERVICE	FRIENDS	BUXOM
SEVERAL	FRONT	YUMMY
UNTIL	PRESS	STRENGTHS
OTHERS	RESPONSE	UNZIP
HAVING	SENSE	JOCKEY
PERSON	ALLOW	TWELFTH
DOING	COMMENT	JINX
MAYBE	HOURS	WAVY
SEEMS	LEAVE	WRISTWATCH
THREE	NORTH	FUNNY
SERVER	RELATED	BAGPIPES
BLACK	RELEASE	KILOBYTE
GETTING	EARLY	FISHHOOK
NOTHING	HARDWARE	WHIZZING
POSSIBLE	ITSELF	FUCHSIA
SMALL	MONTH	KNAPSACK
TRYING	ORGANISM	KAYAK
BUSINESS	STREET	TRANSGRESS
CHANGE	TRADE	KIOSK
COMPANY	EXACTLY	GIZMO
TIMES	FORCE	THUMBSCREW
QUITE	LIVING	WAVE
CONTROL	LOCUS	BOXCAR
PRICE	COLOR	AVENUE
PUBLIC	DIFFERENCE	LUCKY
CURRENT	MARCH	WITCHCRAFT
SECOND	PARTICULAR	WHOMEVER
WHITE	PRESIDENT	NYMPH
GENERAL	SCREEN	STYMIED
ALREADY	OPINIONS	SPHINX
NETWORK	PERFORMANCE	FOXGLOVE
QUESTIONS	RECENTLY	KEYHOLE
RATHER	BASIC	QUIXOTIC
RUNNING	COMING	FAKING
INCLUDE	CREATE	CRYPT
POSITION	INCLUDES	SCRATCH
REMEMBER	LONGER	TWELFTHS
CONTACT	NUMBERS	QUIPS
PHONE	PLAYING	BANDWAGON
INCLUDING	PROGRAMMING	CURACAO
LOCAL	TAKEN	MICROWAVE
STUFF	WRITING	ZOMBIE
EXAMPLE	CERTAINLY	OXIDIZE
WORKS	MANAGEMENT	JUICY
WRONG	DEPARTMENT	OXYGEN
DURING	LEARN	PSYCHE
SUBJECT	LIKELY	ZILCH
LARGE	NEEDED	FRAZZLED
MAKES	RADIO	BANJO
MUSIC	TAKES	JAZZIEST
POSTED	AUCTION	LENGTHS
WORKING	ENVIRONMENT	UPTOWN
HEARD	HAPPY	BUFFALO
REASON	LOOKS	VODKA
SERVICES	NORMAL	GABBY
WRITE	CONDITION	KAZOO
BASED	DIRECTLY	UNKNOWN
DEVELOPMENT	ENGINEERING	RICKSHAW
LEVEL	FINALLY	JUMBO
MEANS	SPECIFIC	VOYEURISM
POSTING	TAKING	SHIV
PRETTY	TOTAL	WIZARD
GAMES	IDEAS	HYPHEN
ORIGINAL	INCLUDED	GOSSIP
RESEARCH	SOUNDS	PHLEGM
GIVEN	STRONG	BEEKEEPER
SOUND	WEEKS	COCKINESS
MACHINE	ANYBODY	TRIPHTHONG
WHOLE	DETAILS	DWARVES
WITHIN	DRIVER	FLAPJACK
EVERYONE	OPINION	KLUTZ
MAKING	POLITICAL	YOUTHFUL
SCHOOL	THEMSELVES	RAZZMATAZZ
TRIED	CLIENT	NIGHTCLUB
ISSUE	OTHERWISE	VAPORIZE
OFTEN	OUTSIDE	JAZZY
MEMORY	PREVIOUS	EQUIP
NATIONAL	COMPANIES	WOOZY
LIBRARY	MAILING	YIPPEE
SPACE	RECEIVE	SCHNAPPS
STATES	EFFECT	QUEUE
EVERYTHING	MODEL	JOVIAL
WHETHER	REQUEST	AZURE
ALMOST	RESULT	FJORD
BOOKS	YOUNG	AWKWARD
TECHNOLOGY	APPLE	IVY
WOMEN	HAPPEN	STRETCH
ALTHOUGH	SOUTH	SWIVEL
DEFINITION	WOMAN	AXIOM
DESIGN	CHOICE	JOKING
MATTER	INDIVIDUAL	FRIZZLED
VIDEO	RESULTS	MNEMONIC
ANSWER	ACCORDING	JAYWALK
PERHAPS	BEHIND	JELLY
PROGRAMS	MESSAGES	PUZZLING
CANNOT	NAMES	WIMPY
GROUPS	PAGES	BAYOU
LATER	PRESENT	XYLOPHONE
PERSONAL	COVER	ASKEW
STANDARD	LOOKED	BLIZZARD
UNDERSTAND	MEMBER	STRENGTH
USERS	PAPER	SQUAWK
COUNTRY	THINKING	ZODIAC
IMPORTANT	CHARACTER	EUOUAE
INSTEAD	IMAGE	SPRITZ
SPECIAL	INSIDE	GLYPH
USUALLY	LIMITED	IVORY
WATER	MINUTES	HAPHAZARD
INTERNATIONAL	CLONE	SNAZZY
AGREE	LEGAL	GLOWWORM